

NO ./textures/LoamWall_1.png
SO ./textures/claywall2.png
WE ./textures/LoamWall_3.png
EA ./textures/LoamWall_4.png

 F     169, 161,          140


C    135,  206, 235





111111111111111111           1111
101001000000001001           10001
101101000000010101           10001
101010100000010011          1000111
1000110000010000011         10001
1000110000000000011         100011
1000110000W000000001         10001
10001100000000000001       110011
10001111111111111101     11000101
10001            101111 10001111
1001          11100000010001
101         110000000000001
101        10000000000000001
101       1000000000000000001
101111111100000000000000000001
100000000000000000010000000001
111111111100000000000000000001
          1000000000000000001
           10000000000000001
            110000000000011
              111000001111
               1111111








            
