

NO ./path_to_the_north_texture
SO ./path_to_the_south_texture
WE ./path_to_the_west_texture
EA ./path_to_the_east_texture

F      220,222,222
C 225,30,1




111111111111111111           1111
100001000000000001           10001
100000000000000101           10001
100001000000000001           10001
100010000001000001           10001
1000110000000000011          10001
10001100000000000001         10001
10001100000000000001       110011
10001111111111111101     1100011
10001            101111 100011
1001          11100000010001
101         110000000000001
101        10000000000000001
101       1000000000000000001
101111111100000000000000000001
100000000000000000010000000001
111111111100000000000000000001
          1000000000000000001
           10000000000000001
            110000S00000011
              111000001111
               1111111

            
