111111111
100010001
100000001
110010001
100001001
100000001
111111111