111111111
100000001
100000001
111110001
100010001
100000001
111111111