111111111
100010001
100000001
110000001
100000001
100010001
111111111