
111111111
100000001
100000001
1010W0101
100000001
100000001
111111111