


NO ./textures/black-texture.png
SO ./textures/black-texture.png
WE ./textures/black-texture.png
EA ./textures/black-texture.png

        F      	8, 37, 48

C    	135, 206, 235






11111111111111111111111111111111111111111111111111
10000000011000000000000111000000001100000000000011
11111111100000111000000011111111110000011100000001
10010000W00000000000000011001000000000000000000001
11111111101100000111000011111111111111111111101101
10000000001100000111011111111111110000000001100011
11110111111111011100000010001111110111111111011101
11110111111111011111011111111101010101001000111101
11000000110101011100000010001110000001101010111001
10000000000000001100000010001100000000000000011001
11000001110101010101011001111100000111010101010101
11110111111010110001101000111110111111010110001101
11111111111111111111111111111111111111111111111111




