

    NO textures/claywall1.png







SO textures/claywall4.png


WE             textures/claywall3.png



            EA textures/claywall2.png

F   100   , 10, 200

C   15, 33   , 01





111111
10N01
11111

