

NO ./path_to_the_north_texture
SO ./path_to_the_south_texture
WE ./path_to_the_west_texture
EA ./path_to_the_east_texture

F      220,222,222
C 225,30,1


1111111111111111111
11000010000000000011
11000000000010000011
11000010000000000011
11000100000010000011
11000110000000000011
11000110001100000011
11000110000000000011
1111111111111111111    


            
