

NO ./textures/claywall1.png
SO ./textures/images.png
WE ./textures/test.png
EA ./textures/claywall2.png

F 220,222,222
C 225,30,1


1111111111111111111
11000010000000000011
11000000000010000011
11000010E00000000011
11000100000010000011
11000110000000000011
11000110001100000011
11000110000000000011
1111111111111111111    


            
