

NO ./textures/claywall1.png
SO ./textures/claywall4.png
WE ./textures/claywall3.png
EA ./textures/claywall2.png

F 220,222,222
C 225,30,1


111111111111111111111111111111111111111111111111111
1100001000000000000000000000000000000000000000000011
1100000000001000000000000000000000000000000000000011
1100000000001000000000000000000000000000000000000011
1100000000001000000000000000000000000000000000000011
1100000000001000000000000000000000000000000000000011
1100000000001000000000000000000000000000000000000011
1100000000001000000000000000000000000000000000000011
1100000000001000000000000000000000000000000000000011
1100000000001000000000000000000000000000000000000011
1100000000001000000000000000000000000000000000000011
11000010E0000100000000000000000000000000000000000011
1100010000001000000000000000000000000000000000000011
1100011000000000000000000000000000000000000000000011
1100011000110000000000000000000000000000000000000011
1100011000000000000000000000000000000000000000000011
111111111111111111111111111111111111111111111111111    


            
