

NO textures/claywall1.png
SO textures/claywall4.png
WE textures/claywall3.png
EA textures/claywall2.png

F   8, 37, 48
C    	135, 206, 25




11111111111111111111111111111111111111111111111111111111
10000000000000000000000000000000000000000000000000000001
10000000000000000000011111111111111111111111111111000001
10000000000000000000000000000000000000000000000000000001
10000000000000000000000000000000000000000000000000000001
11111111111111111111110000000000000000000000000000000011
10000000000000000000000000000000000000000000000000000001
10000000000000000000000000000000000000000000000000000001
10000000000000000000000000000000000000000000000000000001
10000000000000000000000000000000000000000000000000000001
10000000000000000000000000000000000000000000000000000001
10000011111111111111111111111111111111111111111111111101
10000000000000000000000000000000000000000000000000000001
10000000000000000000000000000000000000000000000000000001
11111111111111111111111111111111111111111100000000000001
10000000000000000000000000000000000000000000000000000001
10000000000000000000000000000000001111111111111111111111
11111111111111111100000000000000000000000000000000000W01
10000000000000000000000000000000000000000000000000000001
11111111111111111111111111111111111111111111111111111111




                                
