

NO textures/claywall1.png
SO textures/claywall4.png
WE textures/claywall3.png
EA textures/claywall2.png

F                        220,222,   222




C                         225,         30,      0   















111111111111111111111111111111111111111111111111111
 1
1E1
 1
